bagpipe	Concept
Group Therapy	Entity
coda	Concept
Dave Brockie	Entity
Third Stage	Entity
preface	Concept
Heartland rock	Concept
Dance-rock	Concept
Gittler guitar	Concept
Latin hip-hop	Concept
passage	Concept
Nirvana	Entity
keyboardist	Concept
Zeraphine	Entity
Massive Attack	Entity
anticlimax	Concept
Mikey Chung	Entity
Grapevyne	Entity
suspended cymbal	Concept
Trap House	Entity
Christian rock	Concept
Russian guitar	Concept
marimba	Concept
Steve Mackey	Entity
Rockfest	Entity
Taiwanese pop	Concept
musical phrase	Concept
Origin	Entity
operetta	Concept
Electric guitar	Concept
classic big band	Concept
christmas	Concept
saxophone	Concept
soundtrack	Concept
epigraph	Concept
largo	Concept
Pakistani rock	Concept
French rock	Concept
antiphonary	Concept
Mackey Feary	Entity
Apoptygma Berzerk	Entity
heavy metal	Concept
King Crimson	Entity
seven-string guitar	Concept
Hockey	Entity
The Donkeys	Entity
John Peel	Entity
Thornography	Entity
hymn	Concept
temple blocks	Concept
Space Monkeys	Entity
boogie	Concept
quintette	Concept
piccolo trumpet	Concept
movement	Concept
Photograph	Entity
Live Forever	Entity
christian	Concept
fugue	Concept
minuets	Concept
polyphonic music	Concept
vibraphonist	Concept
preamble	Concept
Planningtorock	Entity
fantasies	Concept
Duke Ellington	Entity
golden oldie	Concept
Fursaxa	Entity
shock rock	Concept
bop	Concept
study	Concept
Mike Hickey	Entity
rock and roll	Concept
harmonisation	Concept
baritone horn	Concept
Tony Brock	Entity
Russian pop	Concept
Angela McCluskey	Entity
rainstick	Concept
Take Me Out	Entity
vihuela	Concept
Shamrock Diaries	Entity
sextet	Concept
Lithuanian rock	Concept
Silverthorn	Entity
Eminem	Entity
singing	Concept
punk revival	Concept
idyll	Concept
Velvet Monkeys	Entity
Celtic rock	Concept
introit	Concept
symphony	Concept
Shakey Ground	Entity
etude	Concept
Lollipop	Entity
panpipes	Concept
Iris	Entity
straight edge	Concept
Smokey	Entity
Whiskey Tango Ghosts	Entity
freestyle	Concept
Beastie Boys	Entity
Stronger	Entity
The Smiths	Entity
crumhorn	Concept
a cappella singing	Concept
The Magic Flute	Entity
contemporary blues	Concept
glockenspiel	Concept
karaoke	Concept
pop music	Concept
soul	Concept
clavichord	Concept
Quincy Jones	Entity
wedding music	Concept
piece of music	Concept
ukelele	Concept
phrase	Concept
flamenco	Concept
harmonium	Concept
vocal blues	Concept
Let It Be	Entity
The Clearing	Entity
Donkey	Entity
The Prodigy	Entity
old-time country	Concept
lyre	Concept
arrangement	Concept
Oasis	Entity
Miles Davis	Entity
Frank Zappa	Entity
punk rock	Concept
signature	Concept
contemporary big band	Concept
maracas	Concept
salsa	Concept
flourish	Concept
Black Sabbath	Entity
four-part harmony	Concept
tarantella	Concept
My Bloody Valentine	Entity
Paint It Black	Entity
jaw harp	Concept
serenade	Concept
gradual	Concept
Handbags and Gladrags	Entity
waltzes	Concept
cantillation	Concept
chansons	Concept
Elvis Presley	Entity
hip-hop	Concept
musical accompaniment	Concept
Fairport Convention	Entity
grand piano	Concept
baroque pop	Concept
arias	Concept
monochord	Concept
funk rock	Concept
chamber music	Concept
swing jazz	Concept
bouffe	Concept
negro spiritual	Concept
mazurkas	Concept
martial music	Concept
scat singing	Concept
theme song	Concept
sonata	Concept
Grateful Dead	Entity
cadenza	Concept
inversion	Concept
opera	Concept
Deep Purple	Entity
musical bow	Concept
Stream of Consciousness	Entity
syncopation	Concept
violoncello	Concept
rock	Concept
oratorio	Concept
emo	Concept
Björk	Entity
west coast blues	Concept
kalimba	Concept
dubstep	Concept
Megadeth	Entity
blues	Concept
extract	Concept
electric blues	Concept
hard rock	Concept
celtic folk	Concept
electronica	Concept
motet	Concept
delta blues	Concept
basset horn	Concept
Some Kinda Rush	Entity
antiphonal	Concept
folk ballad	Concept
world dance	Concept
american alternative	Concept
chamber pop	Concept
yodeling	Concept
quickstep	Concept
punk	Concept
pibroch	Concept
swing	Concept
Avatar	Entity
concertos	Concept
industrial	Concept
americana	Concept
tributes	Concept
crooning	Concept
post hardcore	Concept
kick drum	Concept
Hollywood	Entity
piano blues	Concept
Genesis	Entity
jive	Concept
british punk	Concept
ballads	Concept
preludes	Concept
Elton John	Entity
percussion	Concept
acid jazz	Concept
twee pop	Concept
reggaeton	Concept
shawm	Concept
musical harmony	Concept
Pearl Jam	Entity
regional blues	Concept
dulcimer	Concept
singsong	Concept
chantey	Concept
proto punk	Concept
death metal	Concept
preparation	Concept
thumb piano	Concept
piano sonata	Concept
tone poems	Concept
electronic pop	Concept
rag	Concept
lullaby	Concept
cittern	Concept
drum set	Concept
piccolo	Concept
djembe	Concept
voices	Concept
3 Words	Entity
rap	Concept
instrumentation	Concept
new jack	Concept
trance	Concept
rap rock	Concept
art rock	Concept
tambourine	Concept
banjo	Concept
reharmonization	Concept
andante	Concept
track	Concept
quote	Concept
pan flute	Concept
Brazilian rock	Concept
southern soul	Concept
harmonization	Concept
swedish pop	Concept
traditional	Concept
southern rap	Concept
italian pop	Concept
Latin jazz	Concept
spoken word	Concept
claves	Concept
western swing	Concept
intonation	Concept
arioso	Concept
melody	Concept
elegies	Concept
lieder	Concept
cornet	Concept
Motörhead	Entity
pastoral	Concept
northern	Concept
timpani	Concept
pop metal	Concept
theme	Concept
Whip My Hair	Entity
new jazz	Concept
piano	Concept
black music	Concept
programme music	Concept
sing-a-longs	Concept
counterpoint	Concept
waltz	Concept
instrumental music	Concept
Dream Theater	Entity
solmization	Concept
homophony	Concept
organ	Concept
finger cymbals	Concept
primo	Concept
disco	Concept
incidental music	Concept
southern gospel	Concept
gospel	Concept
sleigh bells	Concept
bachata	Concept
etudes	Concept
shoegazing	Concept
Blur	Entity
traditional pop	Concept
recitative	Concept
salutation	Concept
mbira	Concept
cabaret	Concept
barcarolle	Concept
motown	Concept
canons	Concept
score	Concept
recessional	Concept
solo	Concept
dixieland	Concept
symphonic music	Concept
leitmotif	Concept
prelude	Concept
habanera	Concept
Dreamtime	Entity
adagio	Concept
torch song	Concept
Yes	Entity
Louis Armstrong	Entity
masses	Concept
Neil Young	Entity
pop	Concept
fugues	Concept
Bruce Springsteen	Entity
melodic line	Concept
ranchera	Concept
scherzo	Concept
humming	Concept
impromptu	Concept
odes	Concept
chorale prelude	Concept
musical saw	Concept
Edwin Birdsong	Entity
quintet	Concept
work song	Concept
singalong	Concept
french pop	Concept
overture	Concept
orchestral jazz	Concept
soft rock	Concept
rock'n'roll	Concept
Judas Priest	Entity
adult alternative	Concept
DJ Sharkey	Entity
fado	Concept
merengue	Concept
shanty	Concept
baritone guitar	Concept
ratchet	Concept
voice	Concept
bolero	Concept
keyed trumpet	Concept
monody	Concept
industrial dance	Concept
descant	Concept
canon	Concept
postlude	Concept
Frank Sinatra	Entity
rock guitarists	Concept
violin	Concept
snare drum	Concept
grand opera	Concept
surf rock	Concept
flageolet	Concept
harmony	Concept
composition	Concept
plainsong	Concept
crwth	Concept
love-song	Concept
disco music	Concept
Peter Gabriel	Entity
cymbal	Concept
Dark Passion Play	Entity
The Reeling	Entity
tune	Concept
traditional folk	Concept
Mayhem	Entity
country music	Concept
figured bass	Concept
musical composition	Concept
jazz fusion	Concept
serial music	Concept
AC/DC	Entity
korean pop	Concept
The Beyond	Entity
Paul McCartney	Entity
twelve-tone system	Concept
comedic music	Concept
musical drama	Concept
ska	Concept
vocalizing	Concept
teen pop	Concept
melodic theme	Concept
Fallen	Entity
country rock	Concept
brazilian jazz	Concept
rider	Concept
chorus	Concept
serious music	Concept
Prince	Entity
clipping	Concept
big beat	Concept
U2	Entity
motive	Concept
vallenato	Concept
bongos	Concept
nocturnes	Concept
gregorian chant	Concept
tuba	Concept
bongo drums	Concept
morceau	Concept
songstress	Concept
turntablists	Concept
Baker Street	Entity
requiem	Concept
Led Zeppelin	Entity
carol	Concept
Unity Band	Entity
movie soundtrack	Concept
drumming	Concept
cowboy	Concept
For Sleepyheads Only	Entity
Aphex Twin	Entity
Pink Floyd	Entity
Artwork	Entity
Only U	Entity
folk songs	Concept
american punk	Concept
backup	Concept
Elvis Costello	Entity
castanets	Concept
radio shows	Concept
polka	Concept
smooth jazz	Concept
tenor saxophone	Concept
drum & bass	Concept
obbligato	Concept
obligato	Concept
rap music	Concept
math rock	Concept
quartette	Concept
adult contemporary	Concept
lullabies	Concept
discant	Concept
trad	Concept
ground bass	Concept
Wu-Tang Clan	Entity
christmas carol	Concept
surf guitar	Concept
Deja Entendu	Entity
Art of Life	Entity
boogie-woogie	Concept
twelve-tone music	Concept
bass part	Concept
After the Storm	Entity
harmonica blues	Concept
variations	Concept
texas blues	Concept
duet	Concept
arena rock	Concept
soprano saxophone	Concept
gittern	Concept
ballroom music	Concept
alto flute	Concept
blues rock	Concept
southern rock	Concept
Avalon	Entity
book	Concept
Nine Inch Nails	Entity
Fleetwood Mac	Entity
program music	Concept
hymnody	Concept
jangle pop	Concept
reggae	Concept
operettas	Concept
finale	Concept
whistling	Concept
improvisation	Concept
Welcome the Night	Entity
Über	Entity
melodic phrase	Concept
Hot Issue	Entity
gavotte	Concept
antiphon	Concept
recapitulation	Concept
Fugazi	Entity
Nightshift	Entity
solfeggio	Concept
dance pop	Concept
zydeco	Concept
Backstreet Boys	Entity